0 0 0 0 0 0 0 0 0 0
0 16 12 9 10 10 9 12 16 0
0 17 10 8 10 22 8 10 17 0
0 16 10 10 10 23 10 10 16 0
0 17 10 10 10 10 10 10 17 0
0 16 10 10 10 10 10 10 16 0
0 17 10 10 10 10 10 10 17 0
0 16 10 9 10 10 9 10 16 0
0 18 20 8 10 10 8 21 19 0